................................................................................
................................................................................
.......................................^+++*^+*^*++*^++.........................
.......................................+*++^+**+^++@*+^.........................
......................................+**++++@+++@*^+++.........................
....................................^++@**+@@+++@+^++*++........................
...................................++*+^+^^*@++*+++@++++........................
....................................++++++++*+*+*++*++*+.**.....................
...................................+^............*+^++*+*+*.....................
................................++.^.............^+^**++^^......................
..........++...................++*.+.............+^^*++@++^.....................
..........+*..++..............++^+++.............+++^+^@++......................
..........+++*++..++.......**++*.........+.++....^**++*++...^+..................
.........+++*^*+..++.......+^*+..........*+**....^++*+++^...*+..................
......^*+*+*+^+...*+++......*+++.........*++.....*+++*++++.++*+.................
++....*@@@@^*^...++*++......++**.........++......^*+*++^^+.++++*................
*+....+@@@+++^+..*^+*+......^++^....+^***++......*+++++*+@++++^.................
*+....++^+*++***++++++^.....*^+*....+@@@*+*....@*+*++++++++^+++++...............
^+....+@@++++^++++*^++++....+++*....+@@+^+.....*+^++*+^++@++^+++++..............
++.....+*+^*+^++*@+*+^++............++++++.....+++*^@**@@@*+*+++++......++++....
+^.....+*^*+++*++@@+***.............^++^+^......++^^+++@@++*^^^++.......^^@+.+..
++.....++@@++++++++**++.............++*++^..........+++++^+^++^*......+++**+++^+
+++@....+@*++^+*+++++++.............+@++*...........+@^*++..**^+......+*.+*^++**
*+^@....++++..*+++*+*++*+^.+*^.....++++++^..........+++^^^................++++++
*+*@....++...*+^*++^*++^+^+^+++....+@++.............*+^**+...............+@*++++
*+++@.......*^+^^*++^^++++^++^*....*++*+....++++....++*^++...........^+.+*+++*++
+*+*@.........++++++**...++**........*+^+++*^++.....++++++..........+*+++**+++++
^++*@........+*++++*++.................*+*++*+*.....+++++*.....^+...*^*++*+^++++
++^^+++^@.......+++^+.................+**+^+^+@*....++*++^....+^+++.++**+^+^*^++
+*+*++++@...++*.+*+^*............++*..+^*^*++++*....++++**....*^*+*.+++*+++++++*
*+++^*++@.....^^+...++^+++.......*+*^..^+^+*+.......++++.........+^+^++@+@@+*+@@
++*+*^+*@..........+++++*^+......++*@+.+++++*....................^*++*@++@*++++@
+*+^**++@..........**++++^+......*+^++*+^++.......................^@^^*+++++**++
*++^*+++**.........+^+.^+++.....+^+++.**.+++++....................^+@+*^+^+^++++
^+++^++++..........***..++*......+^**.++...........................+^^++^+^+++@+
++++++++*+......+^..+...+++......+++^...................++..............*+++^++^
+*^+^++++*......+++++............+*.+++.................+++++++.......^..+++++++
+^+^+++++^......*+^+++...............++++++.............++^^.+^.......++++++++++
+*+++++++*......*..^+...................**................++.*.......^*+^**++**^
+**++*^^*......^+.........@@@@............................+...........++++++@++@
*+++.*+*.......^+...........@*+++@........................+...........^^+*++*+^*
++^+..........+^*...........@*++@@@@@........@*++........++**+..**++^*+++++++^*+
^++^..........^++*++........@@++@@@@@+++++@++*+*^.+++....*+*.^^*+++*+*+++@+@@@+^
*+++.........^+^++++^..+^...@@*@@@@^^++++++++++*+.^*+.....+*.^.+++++++++@@*@@+++
^^++........+++++++++*+*+...@@^**@@+++*++++^++*+++^^^..........+^^*++*++++++^*++
..^+.....^*^+++++.....*.....@@*^+^+++^+++^+++++*+^+++...........+++*+*+++@@*@@@@
........++*+*++.............@@+++^**+^+@@^++*+++++*+++@........++*++*^^*+*++@@@@
........*^*^++..............@@+*@@@*+@+@@@++*^++*+*^++@@@.........+@^+++^*+@@@@@
................................................................................
................................................................................