................................................................................
................................................................................
@@*+*+*++*++*++..........................................**^+++*^*^*++++^++*++@@
@@++*+++^*+++*+........................................***++*+^++*+++**^+++*+++@
+++^++^*+^+^+++.........................................*++++**++*+^++*+++++@+^*
+**^+++*++*^^+++..........................................^+++++^++++*++++**+^++
+++++++^++*^+.....................................................^++++**^++*++*
++++++...*+++......................................................+..........++
^+++**+.......................................................................*+
+++*++*^+............................*+++.......................................
*+*+*^+..............................^*@^.++.................^..................
+**+@^+.............................*++*+^*+*+++.............+^.........*.......
+++^*+..............................+++*^*+^++*+.............*+...^+.+^^+.......
..^+^..............................**+*++*+*^+^+..........^^**++..+^*^*++++*+...
...................................++^+***^*++^++........+++*+++..+^+@@@+*+*+^+.
...................................+*+^++*^+*^*+*..........++++++++@+@@+@**++++.
...................................+*+++++++*+++..............+@^+^@@@++@+@++*++
...................................+++**^++*+++............++++@+^+++*++@*++++++
..............................+....+**+++++^++++...........*+++*^+^++^*+@^++^^++
.......................++^.++++....*+**+*+^++*+++..........++@^+++++^++++++*++++
.......................++@+^*+.....^++^+++*++++*+..........+++*+++++^+++**+++*+*
.......................+++^+*......++++^++@++^+++.........^^++*+^++*+++++^+^++*+
.......................+^+++*+.....*++^*+^++*+*+*.......+^^++**++*^*+++*+++^++^^
.......................+++++++.....^++++^+++^*+++.......+@+@+*++++++^++*^+*^+++*
.........................^^+*......+++**+**+*++^+....++*++*+*+^^++++++*+***+^+^+
.........................*.++......^+++*^+^++*+++....^+++.++^+*^^+*+++++++**+*^+
...........................^+*+....*+++***++^^+*+....*+++...^*+++*++**++*++++*+*
............................^^+.........++.+++++*......+.....+++*+++*^***+^+....
.........................+**++^..............++*+...........*+++**++**^++++^....
........................++*++*^.................+...........*+++@+*+*+*+*+......
.......................+**+++*..............................*.++++****++++......
.......................++^++++.....+..........................*.^++^+**^++......
.......................^+*+*++...*+^*+...........................*^++.++^+......
.......................^^+^....+^+*+++...........................*+^+..**+......
........................++..+^^^..++@^+++............^+..........*++++.*........
........................++.^^.....*@^++++............*+....++@..................
.........................+^+......+^+++^+............++*...++@..................
.........................++.......*+*++*+.............+++++++@..................
.....................................**++.............^+^+++^+++^+^.............
.....................................*+++..............+++++**+*@^+.............
.....................................^...............+*++^++++++@^..............
.....................................+^+...........++^++^^^++*^++^..............
................................^+...*++...........++^+++^^+.....+...^..........
.............................++^++.+++++^.........++**...^+......++^^+++........
..............................*+++++^+^+*++*......+^++....+.......++++@++.......
.............................+^^+**^+++^**++......*+++....**.++.^+*@++*+........
.............................*+++++**+^++++*....+^*++........+*+*+^+^+..........
................................^+++**+***+.....+@@**.........+++++*++..........
................................................................................
................................................................................