................................................................................
................................................................................
@@@++++^++^+++++^+...........................................+^+++++++++*+^+^+*^
@+++...*++*^...++++...........................................*++^+*++^+*+*+*++^
+^......^++*....++*^+......................................++*++++++**++++++^+^+
........++......^++^.......................................++****^+++*^+++@@++++
..............+++++*++......................................^++++*+**+^*++**++*+
..............++@@+++^......................................++^++^++**+*++++*++^
..............+^+@^++*+.......................................+^+++***++++*^+**+
..............^*+@^+**++^....................................+*@@+^+^++++++++^*^
...............+^++*+*+*+...................................+^^+++*^++^++++**++*
..................^++.+++................................+^++++*+++..++^++*^^*++
.......................+................................+@++++++++++..++++++*+++
......................+^..............................*+++++..........++^*+^++^*
.....................^+*....+.........................................++^++^+*^*
......................++....*.........................................*++@@++@++
.....................*+...++++..........................................++++**++
.....................*+^+*+++...................................++........++**+^
..........................+^*++++..............................+++.........^**++
.........................+++++++^^*^^..........................+@^..........++^^
...........................^*+*+^*@@*+.........................+@++^.........++*
............................+++*+@@@+*........................+++@@^+*..........
.............................+**^++++^+.......................+++@@+@++.........
..............................+*++^+*++.....................+*+*+@@++*..........
.............*++.......+@..........+++.......................+^*+@*^............
.............^*+.......++@.........++..........................++^+^++........*.
.............+**+...^+.+^@@.....................................+@++^++....^+^+*
.............+*+@+..^++**@@^*++@...............................**+^+@*++...^++*+
...............+++++*^^^++*++++@.............................+++++^+++**+++@*+^+
........................+^+++++*+^+*^....................+++^+@*++++@+++*++*++*@
........................+*+...^++*++......................+@@@@^+++^^+++*+++++^+
..............................+*++*+......................^**++*+++^*^..**++*+@+
................................+*+^...........................+++*++^*.*+^+++@@
................................++++*...........................+++^.....*+++++@
..........+^....................+^@+^............................^*+....*^+^*^*@
........++++....................+*+++...........................*++^....+++++^++
...++++.+@++...................^*+@^^+........................**++......+++^+.^+
...+^*+*+@+*...............^...+++++*+++*......................^^*......++*++...
...**+*^+**+.........++++*^**..+++*+@@+++.......................+*........++....
...+^^*^*^+^*.......++@@@@@^++^++^++*+++*+.................................^+...
...++^+**+++@......*++^^+@@*+++^**.^++^++..................................+*...
..+++++*++*+@......++++*++*+++..+..*++++^................................+..*+..
..++*+*+++**@....++^@@+*++++@+........................................*+^+..+++.
.....+^^**+@@...++++@@^++++@@*+......++...............................+*^+^+*...
...+*+*^*++@@...+++^+@+++*++@++.....++..+.........................+....*++......
.++^++++++**@....+^+++****@@@++++*++**..++.......................+++*++*+.......
++++++++^+++@.....++++^^++@@@+++@@@@+**+*++.......................+++*+.........
+^++**++++@@@.....++**+^^@@@@@@@@@@@@@++^*^.......................+.............
................................................................................
................................................................................