................................................................................
................................................................................
.............................................+^*+++*....@@@+*++++++++*+++^......
............................................++@+^+++^.....@++++*+++*+++**+......
............................................+++**+**+.....@@**++++@@+++.........
...........................................**+++^+++*........++*+++++*+*++......
..............................................+@+++.++^......*^+^+++@++*+^*+....
..............................................+^+++..+*......^+*++++^+^*+++^+...
..............................................^++...**^+*.....++^+^+*+*+@++++...
.....................................................++++......++*^++^^+^+^+++..
.....................................................+*........^^+++++^+++++@*+.
......................................................++.............^+^+*+@**^.
....................................................+++++*............*+++^@@+@^
.................................................^+++^**+^+..........^++^*+^++@*
.................................................++++^+**++..........++++*@*@@++
.................................................+*^++++*++....*+....+^^+*++@@++
...................................................+++*+++@****^^....++^+^++++*^
.......................................................++@^+**^+.....**+++^+@++^
......................................................^++@++^++++....+*++*+^*++*
......................................................++^@@@*+*+^....++*++*++++@
.......................................................+**+@+^^++....+^+++*++*@@
.......................................................*@+++@*^++....*++++++@++@
.......................................................+++++++**+....*+*+*+++++@
.......................................^+^+.............+^++++^+.....++*+*++*+++
......................................+^*+*^.............+++@++......*@+*^@@+++^
....................................+^^+**++...........+.*^**++......+^+++@@+^*+
..................................**+++^*^^*..+.......+*++@@+@+*......++++@@++++
...............................++.*@@++@+^**+++.......+*++*++++*......^++@@@++++
...............................++*^@@^+***+++^*......+++++*^++..........+*+*++++
................................++^++++*@@@@+........^^*+*++............*+^+++++
................................+*+++*+@@@@@+++......+@@+*++..........**+@@+^++@
.................................+++++^+@@@@+^+....^*++@^.............++++++^*++
.................................+++*+@@@@@@+^*....^+***^................***++++
...................................+.+@@@@+++^+.....++++^...................^++^
.....................................++++^**^+*.............................+*++
.......................................+.*+^++^..............................+**
.........................................++++++*.............................+++
.........................................+*++++*................................
.........................................*...*+^................................
..............................................+++...............................
...............................................+*...............................
................................................................................
................................................................................
................................................................................
................................................................................
................................................................................
................................................................................
................................................................................
................................................................................
................................................................................