................................................................................
................................................................................
..................+*+^***++*^++^....................................+++^^^......
..................+++++^+++++*+....................................+^@+^+^......
.................++++*^+++*^+*+....................................++@****......
.................^++*+@++++**+*.....................................^++*........
...................^++^*^*+^+++..............+^.......................+*+.......
...................+^++@@*+..................*+........................^+.......
....................*++@@@*..................*+........................+++......
.....................++@@@+..................*^.....................*.*+^.......
.....................*++@@+..................++....................++^+++.......
.................+...+++@@+................+*+*............^*...^+*+**+.........
.................++.+^@++^........+........*+*.......++.++^+++..**+^*^*.........
..............+..^++*+++++........+^*.......++++^+++++++*+++*+..^@++............
............+^*++@*+@+............+++.+..+**^+.......*++++@++^++^^..............
............+*+^**+*@*^............++*+.^^+++*...........++++@*.................
..........++^++++*@^^*+++.............++^^+++.............+++++.................
..........+*@+++***++@+*+.............++@@^+++..................................
..........++@*+^@+*++@+**++...........+^+@+@^+..................................
........+**@@**+++*++++++*+.............^+*++*+.................................
.........+++@@++++*+.....*..............++++^+*+*...............................
..........++@@+.+*+++^....................+*++*+................................
........**++@@+.+++^^+......................^^++................................
........*++++++..++++^+.....................+*++................................
........++++....^**+*+^.....................+++.................................
..........*^.....***^.*.........................................................
......................+......................................................+..
...................*+++.....................................................^+*.
...............++.++.......................................................+^*+*
..............+++++*.......................................................+++^*
...............++++^++.....................................................*++^+
...............+^+........................................................+++++@
.............+++++..........................................................+^++
.............+++*...........................................................+++*
....................................................+++......................++*
....................................................^+^......................*++
...............................................+^+++++*.*......................+
...............................................+*+++^+++*++....................+
................................................++*+++*+++^....................*
................................................+++++@+......................+*+
.................................................^+++^+...^**.......+......+++@+
...................................................++^++++^+++*.....++.......++*
...................................................+^....*++^**.....*..+++++*+++
........................................................^+*+^**.....^..+^*+^+@@*
.....................................................^+++^*++*+....*++++^+^++@@@
.....................................................++^+@++***....*^*@@++@@*@@@
.....................................................*++^@++.++.....+*@@++@+*@@@
.....................................................*++++^+........*+@@@+++@@@@
................................................................................
................................................................................